d00000000000000
000000mm0000000
00000m000m00000
x00000mmm000000
0000a0000000000
000000000a00000
0000x000m000000
00000000m000000
y0000000m000000
0000y000m00a000
00000000m000000
z0000000m000000
z0000000m000000
z00000000000000
z0000000000000a
