d00m0000z00m000
0m000mmmmm000mm
0mmm0m0000mmm0m
0m000m0mm00y000
0m0m0m00mmmmmm0
000m00m00000m00
0mmm0mmmm0m0m0m
0m000000mm0xm0m
m00m0mm0m00m000
m0m000m0m0m00m0
00m0m00m00m0mm0
0m000m0m0m00mm0
0m0m0m000m0m000
0m0m0mmmm00mmmm
0m0m0m00000000a