d00m00000000m0x
0m000mmmmmm0m0m
00m0m00000m000m
m0m000mmm0mmmm0
00mm0m00m000000
0m000000m0mmmmm
000m0m00m000000
0mm00m0mymmmmm0
000mm00m0m00m00
mm0m00m00m0mm0m
000m0m00m000m00
0mmm0m0m00m00m0
000m00000m0m0mm
mm0mmm0m0m0m000
z00m000m0000mma