d00m000m000m0mx
0m0m0m0m0mm00m0
0m000m0m0000m00
0m0mm00m0mmm00m
000m00mm00000m0
mm0m00000mmmm00
000mm0mmm00000m
0mmm00mym0mmmmm
000m0mm0m0m0000
mm0mm00000m0mm0
000m00mmm0m00m0
0mmm0mm0000m0m0
000m00m0mm000m0
mm0mm0m0m000m00
z00000m0m0m00ma