dm0000000000000
0m0mmmmmmmmmmm0
000m0000m00xm00
0mm00mm0m0m0m0m
0000m000m0m0m00
mmmmm0mm00m0mm0
000000000m00m00
0mm0mmmmm00m00m
00m0m00000m00m0
0m00m0mmmm00m00
00m000m0000m000
0mym0mm0mmm00m0
0m00m000m000mm0
0mm000mm00mm0m0
00zm000000000ma