d00000m000m0000
mm0mm000m000mmm
00000m0m00m0000
0mmm0m000m0mmm0
0m000m0mm000000
000m00mx0m0mmmm
m0m0m00m0m00000
00m0mm0m00mmmm0
0m00m000m000000
0m0m00m00mmmmmm
0m000mmm0000000
0m0mmmmmmmmmmm0
0m00000000000m0
0mmmmmmmmmmmmm0
000000000000zma